2 0 0 0 0 0 0 0 0 0 0 0 0 0 0 0 0 0 0 0 0 0 0 0 4
3 1 1 1 1 1 1 1 1 1 1 1 9 1 1 1 1 1 1 1 1 1 1 1 5
3 1 9 9 9 1 9 9 9 9 9 1 9 1 9 9 9 9 9 1 9 9 9 1 5
3 1 9 9 9 1 9 9 9 9 9 1 9 1 9 9 9 9 9 1 9 9 9 1 5
3 1 1 1 1 1 1 1 1 1 1 1 1 1 1 1 1 1 1 1 1 1 1 1 5
3 1 9 9 9 1 9 1 9 9 9 9 9 9 9 9 9 1 9 1 9 9 9 1 5
3 1 1 1 1 1 9 1 1 1 9 9 9 9 9 1 1 1 9 1 1 1 1 1 5
6 8 8 8 10 1 9 9 9 1 1 1 1 1 1 1 9 9 9 1 12 8 8 8 7
9 9 9 9 3 1 9 1 1 1 1 1 1 1 1 1 1 1 9 1 5 9 9 9 9
9 0 0 0 11 1 9 1 2 0 0 1 1 1 0 0 4 1 9 1 13 0 0 0 9
1 1 1 1 1 1 1 1 3 1 1 1 1 1 1 1 5 1 1 1 1 1 1 1 1
9 8 8 8 10 1 9 1 6 8 8 8 8 8 8 8 7 1 9 1 12 8 8 8 9
9 9 9 9 3 1 9 1 1 1 1 1 1 1 1 1 1 1 9 1 5 9 9 9 9
2 0 0 0 11 1 9 1 9 9 9 9 9 9 9 9 9 1 9 1 13 0 0 0 4
3 1 1 1 1 1 1 1 1 1 1 9 9 9 1 1 1 1 1 1 1 1 1 1 5
3 1 9 9 9 1 9 9 9 9 1 9 9 9 1 9 9 9 9 1 9 9 9 1 5
3 1 1 1 9 1 1 1 1 1 1 1 1 1 1 1 1 1 1 1 9 1 1 1 5
6 8 10 1 9 1 9 1 9 9 9 9 9 9 9 9 9 1 9 1 9 1 12 8 7
2 0 11 1 9 1 9 1 9 9 9 9 9 9 9 9 9 1 9 1 9 1 13 0 4
3 1 1 1 1 1 9 1 1 1 1 9 9 9 1 1 1 1 9 1 1 1 1 1 5
3 1 9 9 9 9 9 9 9 9 1 9 9 9 1 9 9 9 9 9 9 9 9 1 5
3 1 1 1 1 1 1 1 1 1 1 1 1 1 1 1 1 1 1 1 1 1 1 1 5
3 1 9 9 9 9 9 1 9 9 9 9 9 9 9 9 9 1 9 9 9 9 9 1 5
3 1 1 1 1 1 1 1 1 1 1 1 1 1 1 1 1 1 1 1 1 1 1 1 5
6 8 8 8 8 8 8 8 8 8 8 8 8 8 8 8 8 8 8 8 8 8 8 8 7









